25 25
100 100
29	29	29	29	29	29	29	29	29	29	29	29	29	29	29	29	29	29	29	29	29	29	29	29	29	
29	29	21	22	22	22	22	22	22	23	29	29	29	29	29	29	29	29	29	29	21	22	23	29	29
29	29	28	20	20	20	20	20	20	36	23	29	29	29	21	22	22	22	22	22	35	20	24	29	29
29	29	28	20	20	20	20	20	20	20	24	29	29	21	35	20	20	20	20	20	20	20	24	29	29
29	29	27	34	20	20	20	20	20	20	24	29	29	28	20	20	20	15	20	20	20	20	24	29	29
29	29	29	27	34	20	20	20	20	33	25	29	29	28	20	20	20	20	15	15	30	20	24	29	29
29	29	29	29	27	26	36	20	33	25	29	29	29	28	20	20	20	15	15	20	20	20	24	29	29
29	29	29	29	29	29	27	20	25	29	29	29	29	28	30	20	20	20	20	15	15	20	24	29	29
29	29	29	29	29	29	29	31	29	29	29	29	29	28	20	20	20	15	15	15	15	33	25	29	29
29	29	29	29	29	29	29	31	29	29	29	29	29	27	27	34	20	15	15	15	33	25	29	29	29
29	29	29	29	29	29	29	31	29	29	29	29	29	29	29	27	26	26	15	15	25	29	29	29	29
29	29	21	22	22	22	22	20	22	23	29	29	29	30	29	29	29	29	31	31	29	29	29	29	29
29	29	28	20	20	20	20	20	20	24	29	30	29	29	29	29	29	29	31	31	29	29	29	29	29
29	29	28	20	20	20	20	20	33	25	29	29	29	29	29	29	29	29	31	31	29	29	29	29	29
29	29	27	34	20	20	20	20	24	29	29	29	29	29	29	29	29	21	20	20	23	29	29	29	29
29	29	29	28	20	15	15	15	36	22	23	29	30	29	29	21	22	35	20	15	36	23	29	29	29
29	29	21	35	15	15	15	15	15	15	24	29	29	29	29	28	30	20	20	15	30	24	29	29	29
29	29	28	15	15	15	15	15	15	15	15	32	32	32	32	20	20	15	15	15	15	36	23	29	29
29	29	27	26	26	34	15	15	15	33	25	29	29	29	29	28	15	15	15	15	15	15	24	29	29
29	29	29	29	29	27	34	15	33	25	29	29	29	29	29	27	34	15	15	15	15	15	24	29	29
29	29	29	29	29	29	27	26	25	29	29	29	29	29	29	29	27	34	15	30	15	33	25	29	29
29	29	29	29	29	29	29	29	29	29	29	29	29	29	29	29	29	27	34	15	15	24	29	29	29
29	29	29	30	29	29	29	29	29	29	29	29	29	29	29	29	29	29	27	26	26	25	29	29	29
29	29	29	29	29	29	29	29	29	29	29	29	29	29	29	29	29	29	29	29	29	30	29	29	29
29	29	29	29	29	29	29	29	29	29	29	29	29	29	29	29	29	29	29	29	29	29	29	29	29
