25 25
100 100
29	29	29	29	29	29	29	29	29	29	29	29	29	29	29	29	29	29	29	29	29	29	29	29	29	
29	29	21	22	22	22	22	22	22	23	29	29	29	29	29	29	29	29	29	29	21	22	23	29	29
29	29	28	20	20	20	20	20	20	36	23	29	29	29	21	22	22	22	22	22	35	20	24	29	29
29	29	28	20	20	20	20	20	20	20	24	29	29	21	35	20	20	20	20	20	20	20	24	29	29
29	29	27	34	20	20	20	20	20	20	24	29	29	28	20	20	20	20	20	20	20	20	24	29	29
29	29	29	27	34	20	20	20	20	33	25	29	29	28	20	20	20	20	20	20	41	20	24	29	29
29	29	29	29	27	26	34	20	33	25	29	29	29	28	20	20	20	20	20	20	20	20	24	29	29
29	29	29	29	29	29	28	20	24	29	29	29	29	28	41	20	20	20	20	20	20	20	24	29	29
29	29	29	29	29	29	27	37	25	29	29	29	29	28	20	20	20	20	20	20	20	33	25	29	29
29	29	29	29	29	29	29	31	29	29	29	29	29	27	26	34	20	20	20	20	33	25	29	29	29
29	29	29	29	29	29	21	38	23	29	29	29	29	29	29	27	26	34	20	20	24	29	29	29	29
29	29	21	22	22	22	35	20	36	23	29	29	29	30	29	29	29	27	37	37	25	29	29	29	29
29	29	28	20	20	20	20	20	20	24	29	30	29	29	29	29	29	29	31	31	29	29	29	29	29
29	29	28	20	20	20	20	20	33	25	29	29	29	29	29	29	29	21	38	38	23	29	29	29	29
29	29	27	34	20	20	20	20	24	29	29	29	29	29	29	29	29	28	20	20	24	29	29	29	29
29	29	29	28	20	20	20	20	36	22	23	29	30	29	29	21	22	35	20	20	36	23	29	29	29
29	29	21	35	20	20	20	20	20	20	36	23	29	29	21	35	41	20	20	20	41	24	29	29	29
29	29	28	20	20	20	20	20	20	20	20	39	32	32	40	20	20	20	20	20	20	36	23	29	29
29	29	27	26	26	34	20	20	20	33	26	25	29	29	27	34	20	20	20	20	20	20	24	29	29
29	29	29	29	29	27	34	20	33	25	29	29	29	29	29	27	34	20	20	20	20	20	24	29	29
29	29	29	29	29	29	27	26	25	29	29	29	29	29	29	29	27	34	20	41	20	33	25	29	29
29	29	29	29	29	29	29	29	29	29	29	29	29	29	29	29	29	27	34	20	20	24	29	29	29
29	29	29	30	29	29	29	29	29	29	29	29	29	29	29	29	29	29	27	26	26	25	29	29	29
29	29	29	29	29	29	29	29	29	29	29	29	29	29	29	29	29	29	29	29	29	30	29	29	29
29	29	29	29	29	29	29	29	29	29	29	29	29	29	29	29	29	29	29	29	29	29	29	29	29