25 25
100 100
29	29	29	29	29	29	29	29	29	29	29	29	29	29	29	29	29	29	29	29	29	29	29	29	29	
29	29	21	22	22	22	22	22	22	23	29	29	29	29	29	29	29	29	29	29	21	22	23	29	29
29	29	28	20	20	20	20	20	20	36	23	29	29	29	21	22	22	22	22	22	35	20	24	29	29
29	29	28	20	20	20	20	20	20	20	24	29	29	21	35	20	20	20	20	20	20	20	24	29	29
29	29	27	34	20	20	20	20	20	20	24	29	29	3	20	20	20	13	20	20	20	20	24	29	29
29	29	29	27	34	20	20	20	20	33	25	29	29	3	20	20	20	20	13	13	30	20	24	29	29
29	29	29	29	27	26	26	20	26	25	29	29	29	3	20	20	20	13	13	20	20	20	24	29	29
29	29	29	29	29	29	3	20	3	29	29	29	29	3	30	20	20	20	20	13	13	20	24	29	29
29	29	29	29	29	29	29	31	29	29	29	29	29	3	20	20	20	13	13	13	13	33	25	29	29
29	29	29	29	29	29	29	31	29	29	29	29	29	3	3	3	20	13	13	13	33	25	29	29	29
29	29	29	29	29	29	29	31	29	29	29	29	29	29	29	3	3	3	13	13	25	29	29	29	29
29	29	3	3	3	3	3	20	3	3	29	29	29	30	29	29	29	29	31	31	29	29	29	29	29
29	29	3	20	20	20	20	20	20	3	29	30	29	29	29	29	29	29	31	31	29	29	29	29	29
29	29	3	20	20	20	20	20	3	3	29	29	29	29	29	29	29	29	31	31	29	29	29	29	29
29	29	3	3	20	20	20	20	3	29	29	29	29	29	29	29	29	3	20	20	3	29	29	29	29
29	29	29	3	20	13	13	13	3	3	3	29	30	29	29	3	3	3	20	13	3	3	29	29	29
29	29	3	3	13	13	13	13	13	13	3	29	29	29	29	3	30	20	20	13	30	3	29	29	29
29	29	3	13	13	13	13	13	13	13	13	32	32	32	32	20	20	13	13	13	13	3	3	29	29
29	29	3	3	3	3	13	13	13	3	3	29	29	29	29	3	13	13	13	13	13	13	3	29	29
29	29	29	29	29	3	3	13	3	3	29	29	29	29	29	3	3	13	13	13	13	13	3	29	29
29	29	29	29	29	29	3	3	3	29	29	29	29	29	29	29	3	3	13	30	13	3	3	29	29
29	29	29	29	29	29	29	29	29	29	29	29	29	29	29	29	29	3	3	13	13	3	29	29	29
29	29	29	30	29	29	29	29	29	29	29	29	29	29	29	29	29	29	3	3	3	3	29	29	29
29	29	29	29	29	29	29	29	29	29	29	29	29	29	29	29	29	29	29	29	29	30	29	29	29
29	29	29	29	29	29	29	29	29	29	29	29	29	29	29	29	29	29	29	29	29	29	29	29	29

//island borders 3
//grass is 13