25 25
100 100
1	1	1	1	1	1	1	1	1	1	1	1	1	1	1	1	1	1	1	1	1	1	1	1	1	
1	1	3	3	3	3	3	3	3	3	1	1	1	1	1	1	1	1	1	1	3	3	3	1	1
1	1	3	12	12	12	12	12	12	3	3	1	1	1	3	2	3	3	3	3	3	12	3	1	1
1	1	3	12	12	12	12	12	12	12	3	1	1	3	3	12	12	12	12	12	12	12	3	1	1
1	1	3	3	12	12	12	12	12	12	3	1	1	3	12	12	12	13	12	12	12	12	3	1	1
1	1	1	3	12	12	12	12	12	3	3	1	1	3	12	12	12	12	13	13	2	12	3	1	1
1	1	1	1	3	3	3	12	3	3	1	1	1	3	12	12	12	13	13	12	12	12	3	1	1
1	1	1	1	1	1	3	12	3	1	1	1	1	3	2	12	12	12	12	13	13	12	3	1	1
1	1	1	1	1	1	1	15	1	1	1	1	1	3	12	12	12	13	13	13	13	3	3	1	1
1	1	1	1	1	1	1	15	1	1	1	1	1	3	3	3	12	13	13	13	3	3	1	1	1
1	1	1	1	1	1	1	15	1	1	1	1	1	1	1	3	3	3	13	13	3	1	1	1	1
1	1	3	3	3	3	3	12	3	3	1	1	1	2	1	1	1	1	15	15	1	1	1	1	1
1	1	3	12	12	12	12	12	12	3	1	2	1	1	1	1	1	1	15	15	1	1	1	1	1
1	1	3	12	12	12	12	12	3	3	1	1	1	1	1	1	1	1	15	15	1	1	1	1	1
1	1	3	3	12	12	12	12	3	1	1	1	1	1	1	1	1	3	12	12	3	1	1	1	1
1	1	1	3	12	13	13	13	3	3	3	1	2	1	1	3	3	3	12	13	3	3	1	1	1
1	1	3	3	13	13	13	13	13	13	3	1	1	1	1	3	2	12	12	13	2	3	1	1	1
1	1	3	13	13	13	13	13	13	13	13	14	14	14	14	12	12	13	13	13	13	3	3	1	1
1	1	3	3	3	3	13	13	13	3	3	1	1	1	1	3	13	13	13	13	13	13	3	1	1
1	1	1	1	1	3	3	13	3	3	1	1	1	1	1	3	3	13	13	13	13	13	3	1	1
1	1	1	1	1	1	3	3	3	1	1	1	1	1	1	1	3	3	13	2	13	3	3	1	1
1	1	1	1	1	1	1	1	1	1	1	1	1	1	1	1	1	3	3	13	13	3	1	1	1
1	1	1	2	1	1	1	1	1	1	1	1	1	1	1	1	1	1	3	3	3	3	1	1	1
1	1	1	1	1	1	1	1	1	1	1	1	1	1	1	1	1	1	1	1	1	2	1	1	1
1	1	1	1	1	1	1	1	1	1	1	1	1	1	1	1	1	1	1	1	1	1	1	1	1

//water is 1
//rocks are 2
//island borders 3
//sand is 12
//grass is 13
//bridge is 14-15, horizontal then vertical