15 15
100 100
14 14 14 14 14 14 14 14 14 14 14 14 14 14 14
14 13 13 13 13 13 13 13 13 13 13 13 13 13 14
14 13 13 13 13 13 13 13 13 13 13 13 13 13 14
14 14 14 14 14 14 13 13 13 14 14 14 14 14 14
14 13 13 13 13 13 13 13 13 13 13 13 13 13 14
14 13 13 13 13 13 13 13 13 13 13 13 13 13 14
14 13 13 13 13 13 13 13 13 13 13 13 13 13 14
14 13 13 13 13 13 13 13 13 13 13 13 13 13 14
14 13 13 13 13 13 13 13 13 13 13 13 13 13 14
14 13 13 13 13 13 13 13 13 13 13 13 13 13 14
14 13 13 13 13 13 13 13 13 13 13 13 13 13 14
14 13 13 13 13 13 13 13 13 13 13 13 13 13 14
14 13 13 13 13 13 13 13 13 13 13 13 13 13 14
14 13 13 13 13 13 13 13 13 13 13 13 13 13 14
14 14 14 14 14 14 14 14 14 14 14 14 14 14 14